22
16
######################
#..O..   O  * *     ##
# * O.   O..      O.##
#     O   ..  OO   .##
# .G    ...G. *O   .##
#################  .##
# ....         O.. .##
# .O   ..O    ..G...##
#   ..G O*      **  ##
#  **.. O* ..G..**  ##
#     .###############
# ....             .##
# .O   ..O    ..G...##
#   ..G O*  ....**  ##
#  **.. O* ..G..**  D#
######################